41 83
#####################################################################################
@ #   #     #       #   # #           # #       #         #         #     #   #     #
# # # ### ##### # ### # # # ##### ##### #   ### ##### # ### # ########### ### # ### #
# # #   # #   # # # # #     #   #     # #   #   #     # #   # # # #     #   #   # # #
# # ### # # ##### # # # # ### ####### # #   # ####### # # ##### # # ### # ####### # #
#   #   # #   #       # #   # #         #   #       # #   #       #   #   # # #   # #
# ### ### #    ############ # ### # # # #   ####### # # ### ####### # ### # # # # # #
# # #     #             #     #   # # # #   #   #     #                     #   #   #
### ##### #    #### ############# ### # #   # ######### #               ##### ### ###
#         #     #   #         #   #   # ##  # #   #   # #               #   # #   # #
# ### ### #     # ### ##### # ### #######   # # ### ### # # # ##### # # # # ### ### #
# # # #             # # # # #     # #   #   # # # # #     #   # #   # # # # # #     #
# # ########### ### ### # ### ### # ### #   # # # # # ### ### # # # # ### ### # ### #
# #       # # # # #   #   #     #       #   # #   #   # #     #   # #   #   #     # #
# ##### # # # ### # # # ### ##     ######   # ### ##### # # ##### ##### ### ### ### #
#   # # # #     #   # #   # #           #   #     #   # # #     #     #   # #   # # #
### # ### ##### ##### ### # #       #####   # # # # ### # ####### ####### # # # # ###
# #     # #     #         # #         # #   # # #           #       #   # #   # #   #
# ####### ##### ######### # #       ### #   # # ### #      #### ##### # # # ### ### #
# #   #   # #   # #     # #   # #       # ### #   # #       #       # # # # # #     #
# # # # ### # # # ##### # # ##### ##### #   ### #####       # ### ##### # # # ##### #
# # # #     # # #     #     #   #     # #   #     #         #   #         #     #   #
# # # ### ##### ##### ##### # # ### #####   ### #####  ###  ### ####### ####### # # #
# # #   #                 #   #   # # # #   #                 #     #   #   #   # # #
# # ####### ####### ### # # ##### # # # #   # #######       ##### ######### # #######
# #           #       # #       #   #   #   # # #     ##                      #   # #
# ### #########        #### ### ### # ###   # # ### #       ### ##### ##### # # # # #
#       #               #     #   # # # #   #   #   #         #     #   #   #   #   #
# ####### ######        # # ### # ### # #   ##### ###       # ##### ### ######### # #
# #     # # # #           #   # #       #   # #             #   # #   #   #       # #
# ### ##### # #         ### ### ### # ###   # # #####    ###### # # ### # ######### #
#   #     #       # # # #   #   # # # # #   # # #   #         #   # #   #         # #
# # # # # ##### # # ### # ### # # # # # ### # # ### #       # ##### ### ### ### ### #
# # # # #       #       #   # # #   # # #   # # #      ###  #     # # # # #   # #   #
# ##### ##### # ##### ### ####### # # # #   # # # # #       # # ##### # #   # # # ###
#   #     #   #     # #   #       # # # #   #   # # #       # #     #   #   # # #   #
######### ######### ### ### ### # # # # #   # ####### # # ### ### ### ### ######### #
#         #   #     # # #   #   # # # # #   # #   #   # # #   #     # # #         # #
# ######### ### ##### ########### # # # #   ### ### ### ### ########### ####### ### #
#           #         #           # #       #         #   #                   #     %
#####################################################################################