41 85
#####################################################################################
@*#***#     #       #   # #           # #  *****#    ***  #         #     #   #     #
#*#*#*### ##### # ### # # # ##### ##### #  *###*#####*#*### # ########### ### # ### #
#*#*#***# #   # # # # #     #   #     # #  *#***#    *#*#   # # # #     #   #   # # #
#*#*###*# # ##### # # # # ### ####### # #  *#*#######*#*# ##### # # ### # ####### # #
#***#***# #   #       # #   # #         #  *#*******#*#*  #       #   #   # # #   # #
# ###*### #    ############ # ### # # # #  *#######*#*#*### ####### # ### # # # # # #
# # #*****#             #     #   # # # #  *#   #  ***#*                    #   #   #
### #####*#    #### ############# ### # #  *# #########*#               ##### ### ###
#        *#     #   #         #   #   # ## *# #   #   #*#               #   # #   # #
# ### ###*#     # ### ##### # ### #######  *# # ### ###*# # # ##### # # # # ### ### #
# # # #  ***********# # # # #     # #   #  *# # # # #  ***#   # #   # # # # # #     #
# # ########### ###*### # ### ### # ### #  *# # # # # ###*### # # # # ### ### # ### #
# #       # # # # #***#   #     #       #  *# #   #   # #*    #   # #   #   #     # #
# ##### # # # ### # #*# ### ##     ######  *# ### ##### #*# ##### ##### ### ### ### #
#   # # # #     #   #*#   # #           #  *#     #   # #*#     #     #   # #   # # #
### # ### ##### #####*### # #       #####  *# # # # ### #*####### ####### # # # # ###
# #     # #     #    *****# #         # #  *# # #        *  #       #   # #   # #   #
# ####### ##### #########*# #       ### #***# # ### #    **#### ##### # # # ### ### #
# #   #   # #   # #     #*#   # #       #*### #   # #     **#       # # # # # #     #
# # # # ### # # # ##### #*# ##### ##### #** ### #####      *# ### ##### # # # ##### #
# # # #     # # #     #  ***#   #     # # **#     #        *#   #         #     #   #
# # # ### ##### ##### #####*# # ### #####  *### #####  ### *### ####### ####### # # #
# # #   #                 #*  #   # # # #  *#              *  #     #   #   #   # # #
# # ####### ####### ### # #*##### # # # #  *# #######      *##### ######### # #######
# #           #       # #  *****#   #   #  *# # #     ##   ***********        #   # #
# ### #########        #### ###*### # ###  *# # ### #       ### #####*##### # # # # #
#       #               #     #***# # # #  *#   #   #         #     #***#   #   #   #
# ####### ######        # # ### #*### # #  *##### ###       # ##### ###*######### # #
# #     # # # #           #   # #*****  #  *# #             #   # #   #***#       # #
# ### ##### # #         ### ### ### #*###  *# # #####    ###### # # ### #*######### #
#   #     #       # # # #   #   # # #*# #  *# # #   #         #   # #   #***      # #
# # # # # ##### # # ### # ### # # # #*# ###*# # ### #       # ##### ### ###*### ### #
# # # # #       #       #   # # #   #*# #  *# # #      ###  #     # # # # #*  # #   #
# ##### ##### # ##### ### ####### # #*# #  *# # # # #       # # ##### # #  *# # # ###
#   #     #   #     # #   #       # #*# #  *#   # # #       # #     #   #***# # #   #
######### ######### ### ### ### # # #*# #  *# ####### # # ### ### ### ###*######### #
#         #   #     # # #   #   # # #*# #  *# #   #   # # #   #     # # #*******  # #
# ######### ### ##### ########### # #*# #  *### ### ### ### ########### #######*### #
#           #         #           # #*******#         #   #                   #*****%
#####################################################################################